11111111111111111111111111111111111111111
10000000001010110000000000000001000100011
10111111111010000111111111111101010101011
10100010010110111011000000000101010101011
10101000010010000001011101110101010001011
10001010111011111101000100010101011111011
11101010101000000001010001010100000101011
10101010101011111111011111111111101001111
10100010101010000000001000101011000100011
10001010101010101101111010101011011111011
10111100101010100000000010101000000001011
10100000000010101011111111101011011101011
10111011111000001010000000100011010101011
10000010011111111111111101101011010101011
11111011010000000000000101001011010100011
10000001010111111111110101111011010111111
10111111000000001000110100000001010111111
10001000010110111010010111111100000000011
10101111111111100011110000000110111111111
10100000100010101011011111111110000000011
10101110101010001111010010001000111101011
10101010001000100000010110100010001001011
10111011111011110111110000101010111101011
10000000001000010000011010101010000001011
11111111111111111111111111111111111111111

